        #####               #####               #####               #####               #####
      #########           #########           #########           #########           #########
    ######@######       ######@######       ######@######       ######@######       ######@######
  ######@###@######   ######@###@######   ######@###@######   ######@###@######   ######@###@######
  ####@#######@###### ####@#######@###### ####@#######@###### ####@#######@###### ####@#######@######
 ###@###########@#######@###########@#######@###########@#######@###########@#######@###########@####
 #########@#######@###########@#######@###########@#######@##########   ######@###########@#######@##
###@####@###@##########@####@###@##########@####@###@##########@###       #########@####@###@#########
##############@##@################@##@###@############@##@########         ##@###@############@##@####
##@#@##@#####@#####@##@#@##@#####@#####@##@#@##@#####@#####@##@#.#         ####@##@#@##@#####@#####@##
#########@#####@#############@#####@#############@#####@############       .#############@#####@######
###@#######@######@####@#######@######@####@#######@######@####@######       #.####@#######@######@###
 ####@#######@###@#######@#######@###@#######@#######@###@#######@######         ####@#######@###@####
 ######@#######@###@#######@#######@###@#######@#######@###@#######@######       ######@#######@###@##
   ######@#######@#### ######@#######@#### ######@#######@#### ######@######       ######@#######@####
     ######@##########   ######@##########   ######@##########   ######@######       ######@##########
       ######@######       ######@######       ######@######       ######@######       ######@######
         ######@######       ######@######       ######@######       ######@######       ######@######
           ######@#####        ######@####         ######@####         ######@####         ######@####
             ######@###          ######@##           ######@##           ######@##           ######@##
      ##############@#########################################           #########            ########
    ##############@###################@###################@###           #####@###            ####@###
  ######@###@###@####@####@###@###@#######@##@@@@@@@@@@@@##@##           ##@#####             ##@####
######@###@###@#########@###@###@####@######@@@@###@###@@@####           #.##@###             ####@###
####@#################@############@#######@@@@##@@#@@##@@@###           ###@###              ########
##@##############   #################### ##@@@##@@@@@@@##@@##             #.####                ###@##
########            ###@##       #####   ###@@@##@@@@@##@@@##             ###@###             ########
###@######          ######               ####@@@##@@@##@@@###              ######           ######@###
 ####@######        ##@###                ####@@@##@##@@@####              ###@###        ######@####
 ######@######      ######                 ####@@@###@@@####                ######      ######@######
   ######@######    ###@################# ######@@@#@@@#####                ###@##    ######@######
     ######@#####################################@@@@@########              ##############@######
       ######@########@.@.@.@.@.@.@.@.@.####@@@@#######@@@####              ..@.########@######
         ######@###@##@.@.@.@.@.@.@.@.@.##@@@@@@@#####@@@@@@##              ....##@###@######
           ######@@@##########################@@@@@#@@@@#######################@##@.@######
    ###########@@@@#############################@@@@@@#############################@@.@###########
    #########@@@@#####@.@.@.@.@.@.@.@.@.##@@@############@@@##@.@.@.@.@.@.@.@.@.#####@@.@#########
   ###@####@@@@###@@##@#@#@#@#@#@#@#@#@.###.@@@########@@@@###@#@#@#@#@#@#@#@#@.##.@###@@.@####@###
 ########@@@@###@@.@##.@#@#@#@#@#@#@#@#@###@@.@@@.##@@@@@@####.@#@#.#.#.#.#.#@#.##...@###.@.@########
 ####@#@@@@###@@.@@@##.@.@.@.@.@.@.@.@.@#@####@.@@@#@@@@#@####.@...@.........@.@##.....@###.@.@#@####
 ##@##################@####################################@##########     ####@## ###############@##
 #####################################################################    ########   ################
####@@@###@@@##     ###@#.               #####@@#@@#@@#@@#@####..@####  ####..@###     ##@@@###@@@####
###@@@###@@@###     ###...              ####@@@@@@@@@@@@@@####.@@..@######..@...#      ###@@@###@@@###
##@@@###@@@####     ##@.##              ###@@@##########@@@#######@..####.@.#####      ####@@@###@@@##
##@@##@@@#####      ##..#####           ##@@@############@@@##@####.@.##@..####         #####@@@##@@##
##@##@@@#####       ##.@#####           ##@@####@@.@..####@@##.@####..@...###            #####@@@##.##
####@@@####          ##...@..#          ##@@###@.@#..@..##@@##@@.####....##                ####@@@####
####@@@###           ###@....#          ##@@###@@#####.@.@.@###.@.####..#                   ###@@@###
 ##@@@###             ###..@.##         ##@@###.@######..@..####@.@##                        ###@@@##
###@@@####            #####..##         ##@@###@@##  ############@..#                       ####@@@###
####@@@######            ##.@##         ##@@###@.## #############@..#                      ####@@@####
##@##@@@#######          ##..##         ##@@###@@######@@@@.####@..#                     #####@@@##@##
##.@##@@@@@#####         ##@.##         ##@@###.@#####@@@@@@###...##                   ######@@@##@.##
###@@###@@@@@####        ##..##         ##@@###@@@#@@@@@##@@##.@.##                  ######@@@###@@###
 ###@@@###@@@@####       ##.@##         ##@@####.@@@.@####@@##..##                 ######@@@###@@@###
 ####@@..###@@@############..##         ##@@@############@@@##@###               ######@@@###@@@@####
  ####.@@..###@@###########@.##         ###@@@##########@@.#######              #####@@@###.@@@@####
#####@@.##@..###.@###@###@#...          ####@@@@@@@@@@@@.@#@##.@..              ###@@@###.@@##@@@#####
####@..####.@..###.@###@#####.           #####@@#@@#@@#@#####@##..              ##@.###@@@.####.@@####
##@#########################              ########################        #########################@##
##############################             #####################        ##############################
###@####@.@@@@##@@###@@@@@########        ####@@@@@@@@@@@####      #########@@@@####.@@##@@@@##@@@@###
 ####@#.@@##@@@##@@@###@@@@@###########  ####@@@###@###@@@#### ###########@@@@####.@@##@@#@.#@@@@.###
 #####@@.####@@@##@.#####@@@@@@@############@@@##@@#@@##@@@##########@@@@@@@###########@@####@@######
   ##...######@@@##@########@@@@@@@@@######@@@##@@@@@@@##@@@#####@@@@@@@@@###### ######@@####@@####
  ##.@.##. #.##.@@#### #########@@@@@@####@@@@@##@@@@@##@@@#####@@@@@@########       ##@@####@@##
  #...##    #.##..@###    ##########@@@##@@@@@@@##@@@##@@@##@##@@@##########       ####@@####@@####
  ..@##.      .##...#         #########@#####@@@@##@##@@@#####@#########        #######@@####@@#######
  ..##.#        ##..#             ########@@###@@@###@@###@@########            #####@@@@####@@@@#####
  .##@##.                            #####@@@@##@@@#@@##@@@@#####               ##@@.@@@@####@@@@@@@##
   #.##..                               ####@@@@##@@@##@@@####                  ####@##@@####@@##@####
   ...@..#                              ##@###@@@####@@@###@##                  ##@##.##@@##@@##@##@##
    #....#                              ##@@###@@@##@@@###@@##                  ##..##@##@##@##@##@.##
    ###@.##                             ##@@@###@@@@@@###@@@##                  ###@.##@##@@##@##.@###
     ##..##                             ####@@@###@@@###@@@###                   ###.@.##.##@##.@@###
  #####.@##                             #####@@@######@@@#####                   ####...######@@.####
  #####..##                               ####@@@####@@@#####                      ###..  ###@.@####
 ###@..@.#.                                ####@@@##@@@####                               ##.@@######
 ##..@###.                                  ###@@@##@@@###                                ..@.##@####
###@######            ################## ################     #################           ########@###
###############      ####################################   ##################### ####################
##@############     ####@@##@@##@@##.@#####@##@##.          ####@@##@.##@.##@.#####################@##
###.@.@.@.@.@...    ###@@##@@##@@##@@##@##@#@@#..#          ##@##@@##.@##.@##.@####.@@@@@@@@@@@@@#@###
###.############    ##@@##@@##@@##@.##@.@#@#..#@.#          ##.@##@.##..##..##..###@############@#@###
  #.#@.@.@.@.@.#.   ##@##@@##@.##.@##.@####@##.##.          ###@@##..##..##..##@###@#@@@@@@@@@@#@#@##
   .#.########.#.#. ####@@##@.##@.##.@####.@......          ####@@##.       ..#####@#@########.#@#.##
   .#.#......#@#.#.####@.##@.##..##@.##.##.##############   ##@##@.##       #.@####@#@#@@@@@.#@#.#.##
            .#.#@#.###..##..##..##..##..##@##############   ##.@##@.#       ##..###@#@#@####@#.#.#.
            .#.#.#@###@##..##.   ..##.  ##..@.@.@.@.@.@...  ###@@##..       .##@###@#@#@#@@#@#.#.
              .#.#.#@###.               #########.########  ####@@##.       ..#####@#@#@#@##.#@#.
                .#.####..                 ...@.@#@.@.@.@... ##@##@.##       #.@####@#@#@#@##@#.#.
                  .###.                    ################ ##.@##@.#       ##..###@#@#@#@@..#.#.
                                           .............@.#.###@@##..       .##@###@#@#@######.
                                                      ###.#.####@@##.       ..#####@#@#@@....
                                                      ...@#.##@##..#        #.@####@#@#####
                                                       #.#..##..##..        ##..###@#@@@...
                                                       #..@P###@.#          .##@###@######
                                                        .#..#K##..           .####@.@@@...
                                                        ..####.##.           ..#@########
                                                           #####              ###########
                                                                              #####
